############
#+........+#
#..........#
#..........#
#..........#
#.+........#
#.+..X.....#
#.+........#
#..........#
#..........#
#..........#
#..........#
############