############
#TTTTTTTTTT#
#TTTTTTTTTT#
#TTTTTTTTTT#
#TTTTTTTTTT#
#TTTTTTTTTT#
#TTTTTTTTTT#
#TTTTTTTTTT#
#TTTTTTTTTT#
#TTTTTTTTTT#
#TTTTTTTTTT#
#TTTTTTTTTT#
############