############
####.T.T####
##5#T.T.#5##
####.T.T####
#.T.T.T.T.T#
#T.T.T.T.T.#
#.T.T.T.T.T#
#T.T.T.T.T.#
#.T.T.T.T.T#
####.T.T####
##5#T.T.#5##
####.T.T####
############