############
#A.....JC.*#
#......~~~~#
#......~~~~#
#......~~~~#
#......~~~~#
#..........#
#..........#
#..........#
#..........#
#4.......TT#
#B.......TP#
############