############
#1........1#
#..........#
#..........#
#..........#
#.....3....#
#....3F3...#
#.....3....#
#..........#
#..........#
#..........#
#1........1#
############