############
#..........#
#..4....4..#
#..CCCCCC..#
#..C....C..#
#..C....C..#
#....+B....#
#..C....C..#
#..C....C..#
#..CCCCCC..#
#..4....4..#
#..........#
############