############
#......CJ.P#
#.2....C...#
#......CCCC#
#.........J#
#..........#
#..........#
#..........#
#J.........#
#CCCC......#
#..JC....2.#
#P..C......#
############