############
#..........#
#..+....+..#
#..........#
#..........#
#..........#
#.....K....#
#..........#
#..........#
#....T.....#
#..+....+..#
#..........#
############