############
#W~~~~.~~~~#
#~~~~~.~~~~#
#~~~~~.~~~~#
#~~~~~.~~~~#
#~~~~~.~~~~#
#..........#
#~~~~~.~~~~#
#~~~~~.~~~~#
#~~~~~.~~~~#
#~~~~~.~~~~#
#~~~~~.~~~~#
############

