############
#..........#
#C...CC..._#
#..........#
#.CC....CC.#
#.CCC66CCC.#
#.CCC*.CCC.#
#.CCC66CCC.#
#.CC....CC.#
#..........#
#C...CC...C#
#..........#
############